R         800    600

NO ./game_sources/textures/bitmap-N.xpm
EA ./game_sources/textures/bitmap-E.png
SO ./game_sources/textures/bitmap-S.png
WE ./game_sources/textures/bitmap-W.png

S  ./game_sources/textures/sprite_barrel.png
F  125,100,40

C  25,130,210


    111111111       11111       11111    111111111111111                           1111111111111
  111000N000111     10001       10001    10001111111111111     111111111111111     10000000000011
11100000000000111   10001       10001    10001       110011   11000000000000011    100011111110011
10000111111100011   10001       10001    10001        10001    1111111111110001    10001     110011
100011     11111    10001       10001    10001        10001               11001    10001      110011
10001               10001       10001    10001        10001                1001    10001       110011
10001               10001       10001    10001       110011                1001    10001        11011
10001               10001       10001    10001111111110011         111111111001    10001         1011
10001               10001       10001    100E000000000001         1100000000001    10001         1001
10001               10001       10001    10001111111110011         111111111001    10001         1011
10001               10001       10001    10001       110011                1001    10001        11011
10001               10001       10001    10001        10001                1001    10001       110011
100011     111111111100011     110001111110001        10001               11001    10001      110011
1000011111110000000000000111111100000000000001        10001    1111111111110001111110001     110011
1110000000000011111111100000000000111111110001       110011   110000000000000000000000011111110011
  1010000000111       1110000000111      10001111111111111     1111111111111111111110000000000011
  10111111111           111111111        111111111111111                           1111111011111
  101                                                                                   1101
11101       11111   11111       11111    11111                11111                     1001
10001       10001   10001111111110001    10001                10001                     1011
10001       10001   10000000000000001    10001                10001                     101
10001       10001   10001111111110001    10001                10001                    1101
10001       10001   11011       11111    10001                10001                    1001
10001       10001    101                 10001                10001                    1011
10001       10001    101  11111          10001                10001                    101
10001       10001    1011110001          10001                10001                    101
10001111111110001    1000000001          10001                10001                    101
10000000000000001    1011110001          10001                10001                   1101
10001111111110001    101  11111          10001                10001                   1011
10001       10001    101                 10001                10001                   101
10001       10001   11011       11111    10001                10001                  1101
10001       10001   10001111111110001    10001       11111    10001       11111      10011
10001       10001   10000000000000001    10001111111110001    10001111111110001      1001
10001       10001   10001111111110001    10000000000000001    10000000000000001      1011
11011       11111   11011       11111    11101111111111111    11101111111111111      101
 101                 101                   101                  101                  101
1101111111111111111111011111111111111111111101111111111111111111101111111111111111111101
1000000000000000000000000000000000000000000000000000000000000000000000000000000000000001
1111111111111111111111111111111111111111111111111111111111111111111111111111111111111111



